┌┐───│┌┘─└─│┐─┐┌─┐.┌┐│─│┌─└┐┌┐──┐┌───┌┘┐─┌─┌.┌┌.┘───│┐┐──┐┌OOO.─┐─│.┐┌┌─┐┐┌│┐┐.│┐─┌┌┐┌┘┌┘┐─┐┌┌┐┐└┐┐┌┐─┌.│┌┌┘.─│─┐┐.┘┌┌─│┘─│┌│┐┐┌┐┐.┌┐─┌┐─┌┌┐
└┌┐┘.└┐┘┐└┌┘┌.┌└─│─│└└.└┐└└┐─│┐┘┌└│┌┘.│.┐.└└┐┘──┘┘.└└─┘┐│┘┌OOO┐.┌┐───┐┘─│┌│┘┐┐..┐┌┘┘││┌─┐│.└┌┘─┌┐──┌┐─└.└┌┘┌┐┐│└┘┌┐──┐.└┐└┌┐└─┐└┐┐┐┘┌┘│┌┌└┐─
│┘│.┌└┐┌┐.└─┐─┐┐.┌.│..└┌└.└┘─┘─┐┐.└─│─..┌┐└└┘┌│.┌.┌┌──┐┌┌OOOOO┌OO┘.│└─┐┐└┐└│.┌┌└└┘┐.┘┌└─┌┐┐..┌└┘││.└┌┐┘┐┌.┌┐.┌──┌└┐┐└┘┐┌│.┘┐└│└┐└└┌─┐─┌┐┌┘│└
│─┘┌┘──┐┐┐.┌│┌└└─│─┐─┌─│┘└.└┐│┐│└─┘││.└┌└┐...┌└┐││└┘.┌┐││OOOOOOOO..┐┐─┘┘.│┐┘┌└┐┘┐┌┘┐│┌┘┐└┐┐┌OO┘┌┘OOO┐┘┐┐└.└│└┘┘─└┐│└│┘│┌─┐─┘─┌└──│└┘│─┐└│└┌.
└┐.└┌│┘└┘───│─┘└─┘.┘─┌.┌─┘┌│┌┘┘└─┘.┌┐┘┐│.┘─┌│┐┌┘─┌─┘┐┌┐┐└OO.OOOOO┘┌└└┐┘└─┘┘─└┘│┌┌└│─││.┐┘│┘OOOO.└OOOOO┌│─└.└┘..└┌┌┐───┘┘┘┌┐─┐┌┌┘┌└┘└│└─┌──┘└
│┌─┘└└──┘│└│┘└┐└││┌..└│┘.│┌└┐┐└┐│┐─││┐┌┘.┌└└┘│┐│└│└│─┐.┐┌│┌OOOOO┌└┐│││┌│└│┘││┌└─┘┐│─│└┌┐┐OOOOOO┐┐OOOOO┐┘┐─└┘│┌───┌┘└└┌.│.│┘┌┘┐│┘┌┘─┌┘..│└││.
┌┘┐│.┌┘─││─┐┌││┐└┌└.└─┘┘┐┌─┘││└└┘┘.└│┐││┌─.┘─│┌┘─│┘│─OOO┐OOOOOOOO└│┌┌└┌┐┐└──┌.└└┘─│┐┘┌└┘┌OOOOOO┐┐OOOOO┐┐┌─┘─┘│.┘┐└..└│┌─│.┌─└└└┐┐┘.└┐┐┐│┐└┌─
│.┌│┐┘┘┐└│.││┌─┘─┘.─┘.│┌└┌┘┌└┘─│└┌─.││┐┐┘┌┘┘└─┘┐..┌┐─OOOOOOOOOOOOOOO┐┘.OOO└┘│┐┐┐..└──└└┌OOOOOOOOOOOOOOO┌││└┐.│┐.┘┘─│└┘─.┘.│─│.│└┘.─┌┌└└└───.
┌─┌┌┌.┘│┌┐──│┐│┌└┐┌─┘┐┌┌└┘│.│┌┌└┌┘└└┌│┘..│─┌┌│└─│─└OOOOOOOOOOOOOOOOO┌OOOOO.┌┐┐┌│.┌└│┐└┌OOOOOOOOOOOOOOOO─OO┘┌┘└┐┐┌│─└┐│┘─┌┌┘┘.└┘┐...┘└│└┌└─┌│
.┌┘┐└┐.┌│┘│.│┐┘┐┘└┘┐┘┌┐│─┌┘.┐─┌┐└.┌┌│┌┐┐┐│.└┐┌┌┐.─.OOOOOOOOOOOOOO└OOOOOOO┘│─└┐│..┐┌└┐──OOOOOOOOOO┐OOOOO│OO.│┘OOOOO.└│┌─┌┘┘└─└┐─│─┌..─┐─│┘┌└┘
┐──.┌└┐─┘┐.┌.──┌┐┌─│┐┌┐│┌┘┌┌┘─└│┘┌─┌│┘││┌┘─└┌┐┘│┐.┌OOOOOOOOOOOOOO┘OOOOOOOOO└└┘─│.│┐┌┌┌┐OOOOOOOOOOOOOOOOOOOOOOOOOOO┐.┌┘─│┌│..└──┐┌──┌│┘┌┐─┌─┐
└└┘┌─┘└┐│─┐┘┌│┌─┘─┐└─└┐└┘┘─┌┐┘│.││┌OO│└─┐│─└┘OO┐─OOOOOOOOOOOOOOOOOOOOOOOOOOO┘.││┌┘└OOOOOOOOOOOOOOOOOOOOOOOOOOOOOO┘┌─┘│┌┘┐┌┐─└└─┘┘.┌─┘┌│┘┐┌─└
└─┐└│.└┘┘┐└┘┘└┐┘─│└┘┌┐┘─││││OOOOOOOOOO.OOOO.OOO┘┘OOOOOOOOOOOOOOOOOOOOOOOOOOO┌OOOO─┐OOOO─OOOOOOOOOOOOOOOOOOOOOOOOO┐──┌││┌┘┘┘.┐─│┐└┌│└─┘.└└│┌│
┌┐┘─┐┐.┌─│┘┘───┐┐─.┌OO└OO┌│─OOOOOOOOOOOOOOOOOOO│┌OOOOOOOOOOOOOOOOOOOOOOOO.└OOOOOO─OOOOOOOOOOOOOOOOOOOOOOOOOOOOO└OO─┌││┌│┐┐.───.─┐┌└┐└└┐│─└─┐
┌─┘.└┐─┐└┘┌┐┌└└│┘┘┌OOO┌OO┘┐┌OOOOOOOOOOOOOOOOOO└OO─OOOOOOOOOOOOOOOOOOOOOOOO┘OOOOOOOOOOOOOOOOOOOOOOOOOOOOOOOO.OOOOOOOOO───┌┐┌┘└┘┐└┘.┌┘┘.┘┐┐┐┘┘
││──.└└└┌.──┐─│┘│┘┌OOOOOO┐┌OOOOOOOOOOOOOOOOOOOOOOOOOOOOOOOOOOOOOOOOOOOOOOOOO┐OOOOOOOOOOOO─OO┌OOOOOOOOOOOOOOOOOOOOOOOO.└─└─┐┘┐└┘┐┌─┐┘┐┌.└┌┘..
┐┘.│─┌┌└└┌┘┌─┌OOOOOOOOOOOOOOOOOOOOOOOOOOOOOOOOOOOOOOOOOOOOOOOOOOOO┌OO┐OOOOOOOOOOOOOOOOOOOOOOOOOOOOOOOOOOOOOOOOOOOOOO..│┌││└┐┌─┐│┘┐└┐─┐┐.┘.┌└
.└└│─┌┐┌└┘─┐┘│OOOOOOOOOOOOOOOOOOOOOOOOOOOOOOOOOOOOOOOOOOOOOOOOOOOOOOOOOOOOOOOOOOOOOOOOOOOOOOOOOOOO└OOOOOOOOOOOOO┌OO┘┐┌┌┘.┌──.└┘└┘┐└┐│└─┐.└┐│
─.│.┌┘└┌┌.┌┘└└└OOOOOOOOOOOOOOOOOOOOOOOOOOOOOOOOO┌OOOOOOOOOOOOOOOOOOOOO┘OOOO─OOOOOOOOO.OOOOOOOOOOOOOOOOOOOOOOOOOOOOOOOOO┘─│─┌─┌│┌┌┘└└│─┌┌─┐┘┐
.┌┘┐.┌┌└┐──..└┌OOOOOOOOOOO─OOOOOOOOOOOOOOOOOOOOOOOOOOOOOOOOOO┌OOOOOOOOOOOOOOOOOOOOOOOOOOOOOOOOOOOOOOOOOOOOOOOOOOOOOOOOO.│.│└─┘┐┌┐┘└┐┘┘└│┌┘.│
.┐.┌┐┌│┐│┐┘─┌└┘OOOOOOOOOOOOOOOOOOOOOOOOOOOOOOOOOOOOOOOOOOOOOOOOOOOOOOOOOOOOOOOOOOOOOOOOO─OOOOOOOOOOOOOOOOOOOOOOOOOOOOOO┐┐┐┐┘.┘┘┌└┌┌┘─┌┌─┐.┌┐
┐└┌└└─┘┘┘││┌│─┌OOOOOOOOOOOOOOOOOOOOOOOOOOOOOOOOOOOOOOO─OOOOOOOOOOOOOOOOOOOOOOOOOOOOOOOOOOOOOOOOOOOOOOOOOOOOOOOOOOOOOOOOOO┘.┌│.┌┌─│└┐─│┘┌┘┌─┘
┘└┌.││.└└┘┌┌OO┐OOOOOOOOOOOOOOOOOOOOOOOOOOOOOOOOOOOOOOOOOOOOOOOOOOOOOOOOOOOOOOOOOOOOOOOOOOOOOOO┘OOOOOOOOOOOOOOOOOOOOOOOOOO│.│┐│┐└┐.─│└│┌│─└┌─
.┌┘┌┌─┌──└─OOOOOOOOOOOOOOOOOOOOOOOOOOOOOOOOOOOOOOOOOOOOO┐OOOOOOOOOOOOOOOOOOOOOOOOOOOOO└OOOOOOOOOOOOOOOOOOOOOOOOOOOOOOOOOO┐┌OO┐┐OO┐│.│└┘└┘─│┘
.│└└┘┘│┘.└┘OOOOOOO│OOOOOOOOOOOOOOOOOOOOOOOOOOOOOOOOOOOOOOOOOOOOOOOOOOOOOOOOOOOOOOOOOOOOOOOOOOOOOOOOOOOOOOOOOOOOOOOOOOOOOOOOOOOOOOO┘─┘││┌┘┌└┐
└│┐──┌┘┌┌┘┐OOOOOOOOOOOOOOOOOOOO┌OOOOOOOOOOOOOOOOOOOOOOOOO┘OOOOOOOOOOOOOOOOOOOOOOOOO┐OOOOOOOOOOOOOOOOOOOOO─OOOOOOOOOOOO│┘OOOOOOOOOO┌└│┌────┌┘
│└─┘└┌┐─┐─┌.┌OO┐OOOOOOOOOOOOOOOOOOOOOOOOOOOOOOOOO─OO│OOOOOOOOO┐OOOOOOOOOOOOOOOOOOOOOOOOOOOO└OOOOOOOOOOOOOOOOOOOOOOOOOOOOOOOOOOOOOOO.─┐┌┘┘.└┘
└┐│┌└└┘.OO┐┐OOOOOOOOOOOOOOOOOOOOOO└└OOOOOOOOOOOOOOOOOOOOOOOOOOOOOOOOOOOOOOOO└OOOOOOOOOOOOOOOOOOOOOOOOO└OOOOOOOOOOOOOOOOOOOOOOOOOOOO─│.└┘┌┌.│
┌└└──┘─OOOOOOOOOOOOOOOO┐OOOOOOOOOOOOOOOOOOOOOOOOOOOOOOOOOOOOOOO│OOOO┌OOOOOOOOOOOOOOOOOOOOOOOOOOOOOOO└OOOOOOOOOOOOOOOOOO│OOOOOOOOOO┐─└┐┘┐┌.┐│
┌┐┐└│┘.OOOOOOOOOOOOOOOOOOOOOOOOOOOOOOOOOOOOOOO─OOOOOOOOOOOOOOOOOOOOOOOOOOOOOOOOOOOOOOOOOOOO│OOOOOOOOOOOOOOO└OOOOOOOOOOOOOOOOOOOOOO─┐┘┘┌┘└─┘│
└└─┌┐┐┌OOOOOOOOOOOOOOOOOOOOOOOOOOOOOOOOOOOOOOOOOOOOOO─OOOOO.OOOOOOOOOOOOOOOOOOOOOOOOOOOOOOOOOOOOOOOOOOOOOOOOOOOOOOOOOOOOOOOOOOO┘OO┌┐──┘││.│┐
┌│─│└──OOOOOOOOOOO└OOOOO─OOOOOOOOOOOOOOOO┘OOOOO┌OOOOOOOOOOOOOOOOOOO┐OOOOOOOOOOOOOOOOOOOOOOOOOOOOOOOOOOOOOOOOOOOOOOOOOOOOOOOOO.┌┌│┐└│┘└─┐┐─┌─
│.│..│┐OOOOOO─OOOOOOOOOOOOOOOOOOOOOOOOOOOOOOOOOOO┌OOOOOOOOOOOOOOOOOOOOOOOOOO┘OO─OOOO└OOOOOOOOOOOOOOOOOOOOOOOOOOOOOOOOOOOOOOO└┌OOO┐.┘┐│┘└┐┌└┐
┌│─┌│┌┐─OOOOOOOOOOOOOOOOO│OOOOOOOOOOOOOOOOOOOOOOOOOOOOOOOOOOOOOOOOOOOOOOOOOOOOOOOOOOOOOOOOOO.OOOOOOOOOOOOOOOOOOOOOOOOOOOOOOOO┐OOO─┘┌─┐.└┌┘┌└
└│.OOOOOOOOOOOOOOOOOOO└OOOOOOOOOOOOOOOOOOOOOOOOOOOOOOOOOOO─OOOOOO.OOOOOOOOO┘OOOOOOOOOOOOOOOOOOOOOOOOOOOOO─OOOOOOOOOOOOOOOOOOOOOOO┘┘┘┐│┌└│─┌┘
└│.OOOOOOOOOOOOOOOOOOOOOOOOOOOOOOOOOOOOOOOOOOOOOOOOOOOOOOOOOOOOOOOOOOOOOOOOOOOOOOOOOOOOOOOOOOOOOOOOOOOOOOOOOOOOOOOOOOOOOOO─OOOOOO.│─┐┘┌└──┘┐
..┐│┌└OOOOOOOOOOOOOOOOOOOOOOOOOOOOOOOOOOOOOOOOOOOOOOOOOOOOOOOOOOOOOOOOOOO└OOOOOOOOOOOOOOOOOOOO.┌OOOOOOOO└OOOOOOOOOOOOOOOOOOOOO─└└───│.┐┐└│┌┐
│┘──┌┘OOOOOOOOOOOOOOOOOOOOOOOOOOOOOOOOOOOOOOOOOOOO─OOOOOOOOOOOOOOOO.OOOOOOOOOOOOOOOOOOOOOOOOOOOOOOOOOOOOOOOOOOOOO└OOOOOOOOOOOOO┘└└└┐│┐│┘└┘..
└┘│┌OOOOOOOOOOOOOOO└OOOOOOOOOOOOOOOOOOOOO─OOOOOOOOOOOO┌OOOOO┌OOOOOOOOOOOOOOOOOOOOOOOOOOOOOOOOOOOOO│OOOOOOOOOOOOOOOOOOOOOOOOOOOOOO┘.└└┐┐.┌└─┘
│─┌─OOOOOOOOO│OOOOOOOOOOOOOO└OOOOOOOOOOOOOOOOOOOOOOOOOOOOOOOOO┘┌OOOOOOOOOOO└OOOOOOOOOOOOOOOOOOOOOOOOOO└OOOOOOOOOOOOOOOOOOOOOOOOOO└└┘└┘││┌││┐
│┌┐┘─OOOOOOOOOOOOOOOOOOOOO│OOOOOOOOOOOOOOOOO┌OOOOOOOOOOOO┐OOOOOOOOOOOOOOOOOOOOOOOOOOOOOOOOOOOOOOOOOOOOOOOOOOOOOOOOOOOOOOOOOOOOOOO.│.┌└──└└┐┘
└└┘┌┐│└└OOOOOOOOOOOOOOOOOOOOOOOOOOOOOOOOOOOOOOOOOOOOOOOOOOOOOOOOOO┘OOOOOOOOOOOOOOOOOOOOOOOOOOOOOOOOOOOOOOOOOOOOOOOOO│OOOOOOOOOOOOO.┌┐┘─│─┘.│
│┘.┐││.OOOOOO─OOOOOOOOOOOOOOOOOOOOOOOOOOOOOOO└OOOO└OOOOOOOOOOOOOOOOOOOOOOOOOOOOOOOOOOOOOOOOOOOOOOOOOOOOOOOOOOOOOOOOOOOOOOOO─└OOOOOO───┐│└│┘┘
┐┐┐└└OOOOO┐OOOOOOOOOOOOOOOOOOOOOOOOOOOOOOOOOOOOOOOOOOOOOOOOOOOOOOOOOOOOOOOOOOOOOOOOOOO│OOOOOOOOOOOOOOOOOOO│OOOOOOOOOOOOOOOO┐.┌OOOOO┐│┌└└┐│..
│─┌┐┐OOOOOOOOOOOOO─OOOOOOOOOOOOOOOOOOOOOOOOOOOOOOOOOOOOOOOOOOOOOOOOOOOOOOOOOOOOOOOOOOOOOO─OOOOOOOOOOOOOOOOOOOOOOOOOOOOOOOOOO┘─OOOO│┐│─.└┌└─┘
│─┌┌─┐└OOOOOOOOOOOOOOOOOOOOOOO┘OOOOOOOOOO.OOOOOOOO.OOOOOOOOOOOOOOOOOOOOOOOOOOOOOOOOOOOOOOOOOOOOOOOOOOOOOOOOOOOOOOOOOOOOOOOOO┘─OOOO──┘.│─││└│
┐.┌┘┌┘└OOOOOOOOOOOOOOOOOOOOOOOOOOOOOOOOOOOOOOOOOOOOOOOOOOOOOOOOOO└OOOOOOOOOO││OO└OOOOOOOOOOOOOOOOOOOOOOOOOOOOOOOOO┐OOOOOOOOO│┌OO└└─┌─.┐─└└┐└
│─│┘─┘┌┌┌OOOOOOOOOOOOOOOOOOOOOOOOOOOOOOOOOOOOOOOOOOOOOOOOOOOOOOOOOOOOOOOOOOOOOOOOOOOOOOOOOOOOOOO┘OOOOOOOOOOOOOO┐OOOOOOOOOOOOOOO└┐└┌└┘┌┘│.└│┘
┌.┘┌└┌└└OOOOOOOOOOOOOOOOOOOOOOOOOOOOOOOOOOOOOOOOOOOOOOOOOOOOOOOO│OOOOOOOO│OOOOOOOOOOOOOOOOOOOOOOOOOOOOOOOOOOOOOOOOOOOOOOOOOOOOOOO└──┌┌──┐.│┐
└─.┘.││└OOOOOOOOOOOOOOOOOOOOOOOOOOOOOOOOOOOOOOOOOOOOOOOOOOO─OOOOOOOOOOOOOOOOOOOOOOOOOOOOOOOOOOOOOOOOOOOOOOOOOOOOOOOOOOOOOOOOOOOOO─.┌│.─.┌.┌┐
┘┌──┐┘───└.└OOOOOOOOOOOOOOOOOOOOOOOOOOOOOOOOO┘OOOOOOOOOOOOOOOOOOOOOOOOOOOOOOOOOOOOOOOOOOOOOOOOOOOOOOOOOOOOOOO.OOOOOOOOOOOOOOOOOOO│┌─┘┌└─┘└┘│
│┌┌└┘└└│││.┌OOOOOOOOO└OOOO.OOOOOOOOOOOOOOOOOOOOOOOOOOOOOOOOOOOOOOOOOOOOOOOOOOOOOOOOOOOOOOOOOO│OOOOOOOOOOOOOO┐OOOOOOOOOOOOOOOOOOO─│┘│┌┘┘└┐.┐┐
└┘┌┘┐.──┘┐┐┌┌OOOOOOOOOOOOOOOOOOOOOOOOOOOOOOOOOOOOOOOOOOOOOOOOOOOOOOOOOOOOOOOOOOOOOOOOOOOOOOOOOOOOOOOOOOOOOOOOOOOO│OOOOOOOOOOOOO┐─│┘└┘┌┌┌┘┌└┐
│┌┘┘└┐┌┘│└└OOOOOOOOOOOOOOOOOO┘OOOOOOOOOOOOOOO─OOOOOOOOOOOOOOOOOOOOOOOOOOOOOOOOOOOOOOOOOOOOOOOOOOOOOOOOOOOOOOOOOOOOOOOOOOOOOOOOOOOO.│┌└┐┘─┐.│
└┐┌┌─└─│─┌┐OOOOOOOOOOOOOO│OOOOOOOOOOOOOOOOO┘OO─OOOOOOOOOOOOOOOOOOOOOOOOOOOOOOOOOOOOOOOOOOOOOOOO─OOOOOOOOOOOOOO┘OOOOOOOO─OOOOOOOOOO─└┐┐.││┘┌│
┐│└┘│┌.─┐│┌OOOOOOO┐OOOOOOOOOOOOOOOOOOOOOOOOOOOOOOOOOOOOOOOOOOOOOOOOOOOOOO└OOOOOOOOOOOOOOOOOOOOOOOOOOOOOOOOOOOOOOOOOOOOOOOOOOOOOOOOO.└┘┐└─┐┐│
──┘.││.│└└┌OOOOOOOOOOOOOOOOOOOOOOOOOOOOOOOOOOOOOOOOOOOOOO┐OOOOOOOOOOOOOOOOOOOOOOOOOOOOOOOOOOOOOOOOOOOOOOOOOOOOOOOOOOOOOOOO─OOOOOOOO┐┘└└└┐└─┐
│┘│└┌┐┌│─└┌OOOO└OOOOOOOOOOOOOOOO┌OOOOOOOOOOOOOOOOOOOOOOOOOOOOO└OOOOOOOOOOOOOOOOOO┘OOOOOO│OOOOOOOOOOOOOOOOOOOOOOO┘OOOOOOOOOOOOOOOOO┐┌┌─..└└│┐
└.┘┌│┌OO.OOOOOOOOOOOOO└OOOOOOOOOOOOOOOOOOOOOOOOOOOOOOOOOOO.OOOOOOOOOOOOOO└OOOOOOOOOOOOOOOOOO─OOOOOOOOOOOOOOOOOOOOOOO┘OOOOOOOOOOOOO─┘─│─┌──│┐
┌┘└└OOOO.OOOOOOOOOOOOOOOOOOOO─OOOOOOOOOOOOOOO└OOOOOOOOOOOOOOOOOOOOOOOOOOOOOOOOOOOOOOOOOOOOOOOOOOOOOOOOOOOOOOOOOOOOOOOOOOOOOOOOO┘OO└│┌└─┘└│.│
┘┐┌.OOOOO.OO┌OOOOOOOOOOOOOOOOOOOOOOOOOOOOOOOOOOOOOO┘OOOOOOOO┘OOOOOOOOOOOOOOOOOOOOOOOOOOOOOOOOOOO┌OOOOOOOOOOOOO┘OOOOOOOOOOOOOOOOOOO┘└┌.└.┌┐┌│
└─┐┌OOOOOOOOOOOOOOOOOOOOOOOOOOOOOOOOOOOOOOOOOOOOOOOOOOOO│OOOOOOOOOOOOOOOOOOOOOOOOOOOOOOOOOOOOOOOOOOOOOOOOO─OOOOOOOOO┌OOOOOOOOOOO─│┘┌│┌└─┘┐┘.
└─┘┌─OOOOOOOOOO└OOO┐OOOOOOOOOOOOOOOOOOOOOOOOOOOOOOOOOOOOOOOOOOOOO┐OO┌OOOOOOOOOOOOOOOOOOOOOOOOOOOOOOOOOOOOOOOOOOOOOOOOOOOOOOOOOO┐┘┘┌└┘┐.│└┐┐┐
.└┘.│.│└OOOOOOOOOOOOO└OO┐OOOOOOOOOOOOOOOOOOOOOOOOOOOOOOOOOOOOOO┘.┌└┘─│OOOO└OOOOOOOOOOOOOOOOO┘OOOOOOOOOOOOOOOO┘OOOOOOOOO│OOOOOOOO──└┌┘│┌│┐┌┐┘
└┐┌│┐┐┌┐│┘OOOOOOOOOOOOOOOO─OOOOOO┘OOOOOOOO┐OOOOOOOOOOO┌│OOOOOO┐┐│┘│┐.│┌┌OO└OOOOOOOOOOOOOOOOOOOOOOOOOOOOOOO┐OOOOOOOO┐OOOOOOOOOOOO.┌─│.┌─│─└.│
└┌┘.│┌└OOOOOOOOOOOOOOOOOOOOOOOOOOOOOOOOOOOOOOOOOOOOO┌└OOOOOOOO┐─┐│┌┘─│┌─│──OOOOOOOOOOO┐OOOOOOOOOOOOOOOOOOOOOOOOOOOOOOOOOOOOOOOOOO─.└──..┌┘─└
└┐..┌┘.OOOOOOOOOOOOOOOOOOOOOOOOOOOOOOOOOOOOOOOOOOOOOOOOOOOOOO─┌┐└┘└┘─└┌┐││┘┌OOOOOOOOOOOOOOOOOO┐OOOOOOOOOOOOOOOOOOOOOOOOOOOOOOOOOO┐┐┘│┐┌┌│┐┘│
││└.│└┐└┘┘OOOOOOOOOOOOOOOOOOOOOOOOOOOOOOOOOOOOOOOOOOOOOO│─OO┘┌└┘─┘─│┘││┐───┘┐─OOO┌OOOOOOOOOOOOOOOOOOOOOOOOOOOOOOOOOOO└OOOOOOOO│OO─└┐││─┌└┐┌┌
┌┘│┌│┐┌┐.│OOOOOOOOOOOOOO─OOOOOOOOOOOOOOOOOOOOOO┐OOOOOOOOOOO┐└└┘│.│┘┌.│┘│.└││└─OOOOOOOOOOOOOOOOOOOOOOOOOOOOOOOOOOOOOOOOOOOOOOOOOOO│┌─┘┘─│││.│
..└┐│┌┐┌┌┌OOOOOOOOOOOOOOOOOOOOOOOOOOOOOOOOOOOOOOOOOOOOOOOOO─┐┐│─┐┘.└┐┌.┌─.┌─..OOOOOOOOOOOOOOOOOOOOOOO.OO┌OOOOOOOOO┐OOOOOOOOOOOOOO─┐┘.┌─┐┐┘─┌
──┐│─┌└└└OOOOOOOOOOOOOOOOOO.OOOOOO┌OOOOO.OOOOOOOOOOOOOOOOOO┐─┘┘┘.─┌──┘─└└┐│─┐.└OOOOOOOOOOOOOOOOOOOOOOOOOOOOOOOOOOOOOOOOOOOOOOOOO┌└┌.─│┘┌┐───
││└┐┐┘└││OOOOOOOOOOOOOOO└OOOOOOOOOOOOOOOOOOOOOOOOOOOOOOOOOO┘─┘┐┘└┘┌┘└└..││┐└─└┌OOOOOOOOOOOOOO┘OO─OOOOOOOOOOOOOOOOOOOOOOOOOOOOOOO┐│┌┐┌└.└┐│└│
──.└│┐┘│OOOOOOOOOOOOOOOOOOOOOOOOOOOOOOOOOOOOOOOOOOOOOOOOOOO┘┐.─┐└││┐.┌│┐└┘┌┐─│OOOOOOOOOOOOOOOOOOOOOOOOOOOOOOOOOOOOOOOOOOOOOOOOOOO┐│┘┌┐┐│.│┐┘
┌└┌.└┌.─OOOOOOOOOOOOOOOOOOOOOOOOO.OOOOOOOOOOOOOOOOOOOOOOOOO└─┐│┌┌─┌┐.│└┐┘.└┘┌─OOOOOOOOOOOOOOOOOOOOOOOOOOOO│OOOOOOOOOOOOOOOOOOOOOO┐│OOO┐┘─└┐┘
└┐┐.└│┌┌┘└OOO┘OOOOOO┘OOOOOOOOOOOOOOOOOOOOOOOOOOOOOOOOOO│OO│.│└┘┐┘┘│┘┌│┌│┐──└│.└OOOOOOOOOOO┌OOOOOOOOOOOOOOOOOOOOOOOOOOOOOOOOOOOOOOO─OOOO┘┌.│┐
┌┘─┐.┘┐│┘│OOOOOOOOOOOOOOOOOOOOOOOOOOOOOOOOOOO┌OOOOOOOOOOOOOOO┐.│┌─│┐│┐┌─...│└┐.OOOOOOOOOOOOOOO┘OOOOOOOOOOOOOOOOOOOOOOOOOOOOOOOOOOOOOOOO│└┌└┐
─┘─┐─└┐└─┐┌OOOOOOOOOOOOOOOOOOOOOOOOOOOOOOOOOOOOOOOOOOOOOOOOOO┐┐─││.└.┘┐.┌┐─┘┘┌┌OOOOOOOOOOOOOOOOOOOOOOO└OOOOOOSOOOOOOOOOOOOOOO.OOOOOOOO─┐─┐──
└│└┐┌└│┌┌OOOOOOOOOOOOOOOOOOOOOOOOO┘OOOOOOO│OOOOOOOOOOO.OO─OOOO┐┌│─┐┌└───┘┐┐.┌OOOOOOOOOOOOOOOOOOOOOOOOOOOOOOOOOOOOOOOOOOOOOOOOOOOOOOOOOOOOO┘┐
.│┌└┌─│┌─OOOOOOOOOOOOOOOOOOOOOOOOOOOOOOOOOOOOOOOOOOOOO─┌OOOOOO┌OO─┐┐┘┌┘┌└OOOOOOOOOOOOOO┘OOOOOOOOOOOOOOOOOOOOOOOOOOOOOOOOOOOOOOOOOOOOOOOOOO.┌
┌┌│┘.└└┌┘OOOOOO┐OOOOOOOOOOOOOOOOOOOOOOOOOOOOOOOOOOO.OOOOOOOOOOOOO─│┐─│───OOOOOOOOOOOOOOOOOOOOOOOOOOOOOOOOOOOOOOOOOOOOOOOOOOOOOOOOOOOOOOOOO──
─┘┘.│┐│└│┘┘┌OOOOOOOOOOOOOOOOOOOOOOOOOOOOOO┐OOOOOOOOOOOOOOOOOOOOOO┘└┘─┐│┐└OOOOOOOOOOOOOOOOOOOOOOOOOOOOOOOOOOOOOOOOOOOOOOOOOOO┘OOOOOOOOOOO└└.│
.│─┘┘└┘││└──OOOOOOOO└OOOOOOOOOOOOOOOOOOOOOOOOOOOOO┐OOOOOOOOOOOOOOOO┐┐│┌OOOOOO│OOOOO┘OOOOOOOOOOOOOOOOOOOOOOOOOOOOOOOOOOOOOOOOOOOOOOOOOOOO─│┌│
┐─┘└┐─└└│└└┘└OOOOOOOOOOOOOOOOOOOOOOOOOOOOOOOOOOOOOO─OOOOOOOOO└OOOOOOO─┌OOOOOOOOOOOOOOOOOOOOOOOOOOOOOOOOOOOOOOOOOOOOOOOOOOOOOOOOOOOOOOOO┘.│┌┘
└│┐└└─┐┘.│.│┌┌OOOOOOOOOOOOOOOOOOOOOOOOOOOOOOOOOOOOOOOOOOOOOOO─.OOOOOOOOOOOOOOOOO─OOOOOOOOOOOOOOOOOOOOOOOOOOOOOOOO┘OOOOOOOOOOOOOOOOO.OOO.┌┌┐│
┘└│.┘┌┘.┐┐.┐.┌OOO└OOOOOOOOOOOOOOOOOOOOOOOOOO┘OO┌OOOOOOOOOOOO┘│┌OOOOOOOOOOOOOOO└┌OOOOOOOOOO│OOOOOOOOOOOO.OOOOOOOOOOOOOOOOOOOOOOOOOOOOOOO───│┘
┌┐└─┘│└─┘┌┐┐┐┌.OOOOOO.OOOOOOOOOOOOOOOOOOOOOOOOOOOOOOOOOOOOOOO┐OOOOOOOOOOOOOOOOO┌OOOOOOOOOOOOOOOOOO│OOOOOOOOOOOOOOOOOOOOOOOOOOOOO┌OOOO│││┘│┘│
┐.└│┌┌┘┘┌┌┘OOOOOOOOOOOOOOOOOOOOOOOOOOOOOOOOOOOOOOOOOOOOOOOOOOOOOOOOOOOOOOOOOOOOOOOOOOOOOOOOOOO└OOOOOOOOOOOOOOOOOOOOOOOOOOOOOOOOOOOOO└│─┐└┐─┘
┘┌┌┌─│─┌┌─┐OOOOOOOOOOOOOOOOOOOOOOOOOOOOOO┌OOOOOOOOOOOOOOOOOOOOOOOOOOOOOOOOOOOOOOOOOOOOOOOOOOOOOOOOOOOOOOOOOOOOOOOOOOOOOOOOOOOOOOOOO┐┐┘┘│┐│.┐
┌┌└┘┘┌┐..└┌│┌│OOOOOOOOOOOOOOOO└OOOOOOOOOOOOOO─OOOOOOOOOOOOOOOOO└OOOOOOOOOOOOOOOOOOOOOOOOOOOOO─OOOOOOOOOOOOOOOOOOOOOOOOOOOOOOOOO─OOOO┘┐┌└┌─┐┐
┌┐└──.│.──OOOOOOOOOOOOOOOOOOOOOOOOOOOOOOOOOOOOOOOOOOOOOOOOOOOOOOOOOOOOOOOOOOOO─OOOOOOOOOOOOOOOOOOOOOOOOOOOOOOOOOOOOOOOOOOOOOOOOOOOOO└┐.┘.┘│.
┐┘│┌└─┌┘└└OOOOOO─OOOOOOOOOOOOOOOOOOOOOOOOOOOOOOOOOOOOOOOOOOOOOOOOOOOOOOOOOOOOOOOOOOOOOOOOOOOOOOOOOOOOOOOOOOOOOOOOOOOOOOOOOOOOOOOO│.│─┐┐└└.┐┐
│┐─│─│┌┘.│.OOOOOOOOOOOOOOOOOOO┌OOOOOOOOOOO┌OOOOOO─OOOOOOOOOOOOOOOOOOOOOOOOOOOOOOOOOOOOOOOOOOO┐OOOOOOOOOOOOOOOOOOOOOOOOOOOOOOOOOOOO.└┌┘┘┐└┘..
└└.│└─┘│┌─┘┘OOOOOOOOOOOOO┘OOOOOOOOOOOOOOOOOOOOOOOOOOOOOOOOOOOOOOOOOOOOOOOOOOOOO└OOOOOOOOOOOOOOOOOOO┐OO─OOOOOOOOOOOOOOOOOOOOOOOOOOO──┌┐.┌┌│.└
┌└─┌─┘│┐─││┌OOOOOOOOOOOOOOOOOOOOOOOOOOOOOOOOOOOOOOOOOO└OOOOOO│OOOOOOOOOOOOOOOOOOOOOOOOOOO.OOOOOOOOOOOOOOOOOOOOOOOOOOOOOOOOOOOOOO┘..─┐┐.─┐┌─┐
.└┌└│└┌┌┐┘OOOOOOOOOOOOOOOO┌OOOOOOOOOOOOOOOOO┘OOOOOOOOOOOOOOOOOOOOOOOOOOOOOOOOOOOOOOOOOOOOOOOOOOOOOOOOOOOOOOOOOOOOOOOOOOOOOOOOOO┐┐┐┐└└┌─.──│┐
┌.└┐│┌OO│OOOOOOOO─OOOOOOOOOOOOOO─OOOOOOOOOOOOO└OOOOOOOOOOOOOOOOOOOOOOOOOOOOOOOOOOOOOOOOOOOOO┘OOOOOOOOOOOOOOOOOO┘OO┘OO└OOOOOOOOOOO┐┐.┌┌┐.││┘└
┘.│└┐└OOOOOOOOOOOOOOOOOOOOOOOOOOOOOOOO┌OOOOOOOOOOOOOOOOOOOOOO│OOOOOOOOOOOOOOOOOOOOOOOOOOOOOOOOOOOOOOOOOOOOOOOOOOOOOOOOOOOOOOOOOOO│─│─┘─┌┘└┐┘
┌┌┐││┐OOOOOOOOOOOOOOOOOOOOOOOOOOOOOOOOOOOOOOOOOOOOOOOOOOOOOOOO┐OOOOOOOOOOOOOOOOOOOO┌OOOOOOOOOOOOOOOOOOOOOOOOOOOOOOOOOOOOOOOOOOO└│─┐┘┐│.┘┌┘.│
┌┘┌OOOOOOOOOOOOOOOO┐OO┐OOOOOOOOOOO┌OOOOOOOOOOOOOOOOOOOOOOOOOOOOOOOOOOOOOOOOOOOOOOOOOOOOOOOOOOOOOOOOOO┘OO┐OOOOOOOOOOOOOOOOOOOOO─└.┌┐└│.┌─└┘┐.
│└┌OOOOOOOOOOOOO.OOOOOOOOOOOOOOOOOOOOOOOOOOOOOOOOOOOO┐OOOOOOO─OOOOOOOOOOOOOOOOOOOOOOOOOOOOOO│OOOOOOOOOO┘OOOOOOOOOOOOOOOOOOOOOO─│─└┘┌│─┘┘│─┐┐
┘─OOOOOOOOOOOOOOOOOOOOOOOOOOOOO┌OOOOOOOOOOOOOOOOOOOOOOOOOOOOOOOOOOOOOOOOOOOOOOOOOOOOOOOOOOOOOOOOOOOOOOOOOOOOOOOOOOOOOOOOOO┌OOO┐│.└.─│┐┐┌┌┌─┐
└OOOOOOOOOOOOOOOOOOOOOOOOOOOOOOOOOOOOOOOOOOOOOOOOOOOOOOOOOOOOOOOOOOOOOOOOOOOOOOOOOOOOOOOOOOOOOO│OOOOOOOO┐OOOOOOOOOOOOOOOOOOOOO─┘┐──.└┌┐──┘└┘
.OOOOOOOOOOOOOOOOOOOOOOOOOOOOOOOOO┐OOOOOOOOOOOOOOOOOO┘OOOOOOOO┐OOOOOOOOOOOOOOOOOOOOOOOOOOOOOOOOOOOOOOO─OOOOOOOOOOOOOOOOOOOOOOOO┘┐┐│─┌└──┘..┐
─┘┘┘OOOOOOOOOOOOOOOOOOOOOOOOO│OOOOOOOOOOOOOOOOOOOOOOOOOOOOOOOOOOOOOOOOOOOOOOOOOOOOOOOOOOOOOOOOOOOOOOOOOOOOOOOOOOOOOOOOOOOOOOOOOO┐│┌┐└─┘┐┌│┐│
││┐└OO┘OOOOOOOOOOOOOOOOOOOOOOOOOOOOOOOOOOOOOOOOOOOOOOOOOOOOOOOOOOOOOOOOOOOOOOOOOOOOOO┐.OOOOOO┐OOOOO└OOOOOOOOOOOOOOOOOOOOOOOOOOOO└┐└┘┘┘└┌│┘│┘
└──┌OOOOOOOOOOOOOOOOOOOOOOOOOOOO─OOOOOOOOOOOOOOOOOOOOOOOOOOOOOOOOOOOOOOOOOOOOOOOOOOOOOOOOOOOOOOOOOOOOOOOOOOOOOOOOOOOOOOOOOOOO.OO┐┌┐.│─└─└┐││
┌┘.└OOOOOOOOOOOOOOOOOOOOOOOOOOOOOOOOOOOOOOOOOOOOOOOO│OOOOOOOOOO│OOOOOOOOOOOOOOOOOOOOOOOOOOOOOOOOOOOOOOOOOOOOOOOOOOOOO┘OOOOOO┘─│└│└─┐┐...┌└│┐
└┌┐┘OOOOOOOOOOOOOOOOOOOOO.OOOOOOOOOOOOOOOOOOOOOOOOOOOOOOOOOOOOOOOOOOOOOOOOOOOOOOOOOOOOOOOOOOOOOOOOOOOOOOOOOO└OOOOOOOOOOOOOOO│┘┘└.┐└│└┐│─┐┘││
.└┐┌└└OOOOOOOOOOOOOOOOOOOOOOOOOOOOOOOOOOOOOOOOOOOOOOOOOOO.OOOOOOOOOOOOOOOOOOOOOOOOOOOOOOO─OOOOOOO.OOO┌OOOOOOOOOOOOOOOOOOOO─OO┐┐.┌┐│┌│┐└.│┐┌│
└─└─└.OOOOOOOOOOOOOOOOOOOOOO┘OOOOOOO┘OOOOOOOOOOOOOOOOOOOOOOOOOOOO.OOOO┌OOOOOOOOOOOOOOOOOOOOOOOOOOOOOOOOOOOOOOOOOOOOOOOOOOOOOOOOO└└──┐┘┘─┌┌┌│
│.└.┌┌└OOOOOOOOOOOOOOOOOO┐OOOOOOOOOOOOOOOOOOOOOOOOOOOOOOOOOO┘OOOOOOOOOOOOOOOOOOOOOOOOOOOOOOOOOOOOOOOOOOOOOOOOOOOOOOOOOOOOOOOOOOO─└.┌└││.┐.└┘
┘┘.│┐┌OOOOOOOOOOOOOOOOOOOOOOOOOOOOOOOOOOOOOOOOOOOOOOOOOOOOO│OOOOOOOOOOOOO┌OOOOOOOOOOOOOOO│OOOOO┘OOOOOOOOOOOOOOOOOOOOOOOOOOOOO┌┘┘┘┘┌└┐└┐─└┐..
│┘┌│──OOO┘OOOOOOOOOOOOOOOOOOOOOOOOOOOOOOOOOO┘OOOOOOOOOOOOOOOOOOOOOOOOOOOOOOOOO┘OOOOOOOOOOOOOOOOOOOOOOOOOOOOOOO└OOOOOOOOOOOO┘┘┘─┘┘─││─└┘┌└┐┐└
┌──┌┘┘││││OOOOOOOOOOOOOOOOOOOOOOOOOOOOOOOOOOOOOOO┐OO┌OOOOOOOOOOOOOOOOOOOOOOOOOOOOOOOOOOOOOOOOOOOOOOOOOOOOOOOOOOOOOOOOOOOOOO┐└└│└│┘└└┘│┌└┐┘└┘
┐─│┘│.┐└──OOOOOOOOOOOO─OOOOO.OOOOOOOOOOOOOOOOOOOOOOOOOOOOOOOOOOOOOOOOOOO┌OO┐OOOOOOOOOOOO┘─OOOO┘OOOOOOOOOOOOOOOOOOOOOOOO│OO┌┘┘┌┌─┐│─┌─┌──└┐└└
─┐┌┌─┐│─└─OOOOOOOOOOOOOOOOOOOOOOOOOOOOOOO┘OOOOOO│OOOOOOOOOOO.OOOOOOOOOOOOOOOOOOOOO─OOOOOOOOOOOO─OOOOOOOOOOOOOOOOOOOOOOOOOOO└┌┘└─│─┐┐.└.└└──┐
└└┌┘└└─┐┌┐.┌OOOOOOOOOOOOOOOOOOOOOOOOOOOOOOOOOOOOOOOOOO│OOOOOOOOOOOOOOOOOOOOOOOOOOOOOOOOOOOOOOOOOOOO┐OOOOOOOOOOOOOOOOOOOOOOO┐┘└┐─└─└┌──│┘┘│└─
│└│.┌┐.─│┐┐─OOOOOOOOOOOOOOOOOOOOOOOOOOOOOOOOOOOOOOOOOOOOOOOOOOOOOOOOOOOO┐┘OOOOOOOOOOOOOOOOOOOOOOOOOOOOOOOOOOOOOOOOOOOOOOOO└┘┐│.┐┘└│.└─┘..┐┘.
└┐└─└┌┐┘└.│.└│└┘OOOOOOOOOOOOOOOOOOOOOOOOOOOOOOOOOOOOOOOOOOOOOOOOOOOOOOOOO┐OOOOOOOOOOOOOOOOOOOOOOOOOOOOOO│OOOOOOOOOOOOOOO┌│.└│┌┌└┐.─┐─┘.┌┐┘│└
│┘┌─┌└┐.│┌.┌─┘┌┐└└OOOOOOOOOOOOOOOOOOOOOOOOOOOOOOOOOOOOOOOOOOOOOOOOOOOOOOOOOOOOOOOOOOOOOOOOOOOOOOOO─OOOOOOOOOOOOOOOOOO─OO─┐──.│┘.└┐─│─│┐┌┘.││
│┌┌─┘└─┐─└│─.┌┌┐.┌┐OOOOOOOOOOOOOOOOOOOOOOOOOOOOOOOOOOOOOOOOOOOOOOO┘OOOOOOOOOOOOOOOOOOOOOOOOO│OOOOOOOOOOOO.OOOOOOOOOOO┐─└└│─.└┘┌┌.─┘.┌┘┘└┐.│┐
┌─┘│┘.└┐─┘┘..└┘┐.└┌OOOOOOOOOOOOOOOOOOOOOOOOO┌OOOOOOOOOOOOOOOOOOOOOOOOOO.OOOOOOOOOOOOOOOOOOOOOOO│OOOOOOOOOOOOOOOOOOOOOO.└─┘└│.└└│┐└┌┐│└┐.│─┘│
.└┌│.─.┘.│┌┐┐─│└┘─┌OOOO┘─OOOOOOOOOOOOOOOOOOOOOOOOOOOOOOOOOOOOOOOOOOOOOOOOOOOOOOOOOOOOOOOO┐OOOOOOOOOOOOOOOOOOOOOOOOOOOO┐.└┐┐.┌│┌└┘──┌─.┘─│┘└┐
│┐┌┘┘┘..┌┌─││┌┘.└┘└OOOOOOOOOOOOOOOOOO┌OOOOOOOOOOOO┘OO.OOOOOOOOOO│OOOOOOOOOOOOOOOOOOOOOOO└OOOOOOOOO│OOOOOOOOOOOOOOOOOO┘│┐───│┐.┌│┌┐│.┌┌│┐┌┌┐.
│┌│┐│┌┐┌┌─┐┌─┐.└┐┐│.│OOOOOOOOOOOOOOOOOOOOOOOOOOOOOOOOOOOOOOOOOOOOOOOOOOOOO└OOOOOOOOOOOOOOOOOOOOOOOO│OOOOOOOOOOOOOOOO┘└┌┘─┘.│┐┐─└└┘┌└┌┘┘┌└┘┘┐
└┐┐┘─┘│┌.└┌┘.┌─┌┘┘└│┌OOOOOOOOOOO─OOOOOOOOOOOOOOOOOOOOOOOOOOOOOOOOOOOOOOOOO└OOO│OOOOOOOOOOOOOOOOOOOOOOOOOOOOOOOOOOOOO┘.│─└└┌└│┘┘┐..┌└└┐.││┘┌│
└│┌┘│└│└─┐┘┌─┐.┐┘┐┐│└│─OOOOOOOOOOOOOO└OOOOO└OOOOOOOOOOOOOOO│OOO─OO┌└OOOO│.│─┌└─OOOOOOOOOOOOOOOOOOOOOOOOOOO│OOOOOOOO│.┌┘┐└──┘│┌└│┌┘─.┌└┐└┐.││
.└┐┐│─.┌┌│─┘┐┘.│.└─└─┐┘OOOOO.OOOOOOOOOOOOO┘OOOOOOOOOOOOOOO┐OOOO─OO─┐OOOOO┘┘┐┌│┘┌OOOOOOO┐OOO─OOOOOOO┌OOOOOOOOOOO└└┘.┘─└─┐.└──┐│.└┘┘┘─┘└──┘.──
┘┌│──┘┌┌─│└│└┐─┐┐.┌┌┐┘.OOOOOOOOOOOOOOOOOOOOOOOOOOOO│OOOOOOOOOO┘OOO.─OOOOO┐│└┐┐.┌OOOOOO──│┘││OOOOOO┌OOOOOOOOOOOO─┘─└.└││.┐┌┐│└┐┐..│─┐│┐.└│┌│┘
└─┘│└──┘┌┐.─┘└─.┐┐┐└┘└┌.└┌OOOOOOOOOOO┌OO┘┘OOO└OOOOOOO┐OOOOOOO.└OOO..└┘││└┌┐┘└┐┐┌─OOOOO│││┘└│┌OOOOOOOOOOOO│─└OO.│..└┌.┌┐┐┌┌│┐┌┘┐──┐│┌┘┌─┌└─└.
──└│└┌│┐┘│┐.│┐┌└└└┌┘│┐└│└┌─│└OO│┐OOOO┘─└││└OOOOOOOOOOOOO.│─│┌┐.│OO┐┐.└│─└┘└┌┐└│└─OOOO.┌┐..┌┘┘.OOOOO┌OO│┘┌──└┘┐┘┘┌.─┌┐┘┐┐┌┘└─│┘└┐┘.│└┐┘──┘┘┌┘
└┌─┐┌┐└─┌┘│┐└┌┌.│┘.│││.└┌└┌┐.OO┐─OOOO┘┌└┌─┘OOOOOOOOOOOOO─┘.└┌┘─││┐.──.│└└┌.││─│┐.└┌┘─┌┘┌┐┌─..┌OOOO┌┌OOO┘┌┘┐.┌└.└┌└─┘┘─└──┘─┌│─└┘┐┌┌│┘┌─┐│┐┘.
││─└┌┐┘└│┐┌─.┌┘└─.│└└─┐┌┌┘││┌┐└┘└OOOO┌└┌┘.──OOOO┌OOOO┘┌└│─┌│.─┐.└┐┐─└┐┘.││┌└┘┌┐┐┐┐└┐│.─┐┌┘│└└┐│┌┌┘┌└OOO┐└┐┐┌┐└┌─│┐│┘─┐│└┘.┌└┘┐.│┌│┘└│┘.┐┘┌.┌
┘┌─┐└┌┘.││┐│┐│┐┘┌─┘└│└─┌┘─┘─└┘.┌│┌OO└┐┘│┌┐┌│└OOOOOOOO─└┐┌┘└┌┘└┌┐┐│┐┌┐┘┐┌┐┐─┘└││┌─┘──└.└┘┘└┐┌└─└─┐.└│┌│.│┐└┘┘┐─│─└│┐┘┐│┐.│┌┌...──│││┌┐┘┌└.└─└
└┌─┌┐.┌┌│└│┌┌└─.─.││.┌└│─┌└┘.└┐└─┐┐│─└┐─┘│└OOOOOOOOOOO│┌│─┐└│┘┌┐─┐┐┐.│└┘┘││└┘└┐┌┘.│└┐└┘┘┐┐.┌─┘└└└───┐─┘└┌.│└│──.│└┌┐└┌│┐┘┌──│┘┘└┘┘─┐└┌┘│┌.││
└┘│└│┌┐┐└─└┌┐└┘┌.┌┌┐─┘.└.│──┐.││┌└┐┘┌┘.└┌└.OOOOOOOOOOO─┌┐│──│.└──└┘│.─┐│.│┌└┐┌└┘┐─│┘┌│┐└┌┘───└┌┌┐.┌┌┘┘──.─┌┘└┌│─┌─┘┐│┌└┘┌┘┐┌─┘┌┘│.─┘┘└─┘┘┐┘┐
│.│.└│└┐┘.│└┐┐┌─┐│─││.┌│─┌┌┘.│┘─┐└┘┐│┌┐─┘.┌┘─OOOOOO┘└│└───┐┘│─┐│┌┘┘┐│┌┘─┌┘┌└┘─│┘┘┐└──┌┌┘└┘┐┘──┐┘└└┐│┘.┌─│┐│.┌┌└.│┌┌└└┐└│┘┌└┘│┐┘.┌─┌─┐│─┐.┌.┐
─.┌┐─└┘│┘.│.┘┐┘└┌┘└│┌┐│─┌┌.┌─┘.└..└┌┐│─.│.┐.┌┘┘│OO.┌│.┌│┘└─┐┌─┘─┘│.│┐┐┐─┐─┌.└.└│.┐─┐┐││└│└.┌─└└┐┌└┌┘─││┌└─│┌┐─│┐│┐┐└││┐│││.─┌───└─│└─┘┌┐┌│┌┘
│┌└│┐..│─┌┌┌┐┘┌┐.┐┐│┘┌│.┘.─┘│└└──┐┘└┘┘└└─┐┐┌││.┌OO┐┌┐──.└│.┌──┘┘─┌└┘┌┌─┐┘─└│┘.┌└┘─┐┐──┐┐┌┘┌┌┘┐┐┌│─┐.┐└─┘└.└┌└─┐┐┘└┘─┘┐┐│┐.┌┘│└└┘└┐.└│.┘└│─│.
┘└└└┘.└─┌┐─┘┘┘└──│─│─┘└┌┘┐─┌┐─└─└└.┘┘┘┘.┘.└───┘└└│└└──└─.┘─└│─.──└└─│┘┘│─────┘└└│.└┐─└└└.│─┌──┐─┐─┘│┘└┘┘│┘─┘─└└│.└└└.│┘┘┌.│..└┘─│┘─.┘.└┐┘┘└└